アオイ	葵	美丘アオイ's firstname,girl,student
美丘	美丘	美丘アオイ's lastname,girl,student
レン	莲	player's firstname,boy,student
九条	九条	player's lastname,boy,student
アイカ	爱嘉	花ノ木アイカ's firstname,girl,student
花ノ木	花之木	花ノ木アイカ's lastname,girl,student
シズク	清露	夕凪シズク's firstname,girl,student
夕凪	夕凪	夕凪シズク's lastname,girl,student
窪塚先生	洼塚先生	name
ユキ	雪	汐崎ユキ's firstname,girl,student
汐崎	汐崎	汐崎ユキ's lastname,girl,student
魚屋	鱼铺
八百屋	蔬菜店
エリカ	艾莉卡	猫城エリカ's firstname,girl,student
猫城	猫城	猫城エリカ's lastname,girl,student
司会者	主持人
マキちゃん	真希酱
チエミおばあさん	千惠美奶奶
チエ	千惠	千木野チエ's firstname,girl,student
千木野	千木野	千木野チエ's lastname,girl,student
チエミ	千惠美	name
役員たち	董事们
女子アナ	女主播
猫神宮	猫神宫
猫之大御神	猫之大御神
エリカの父	艾莉卡之父
エリカの母	艾莉卡之母
教員	教员
中華屋の店員	中餐馆的店员
ちびっこ	小鬼
エリカ父	艾莉卡父亲
お笑い芸人	搞笑艺人
クラス全員	全班
荒川先生	荒川先生
下関先生	下関先生
先輩	先辈
悪魔	恶魔
天使	天使
窪塚	洼塚	name
企画部全員	企画部全员
全員	全员
中等部男子	中学男生
中等部女子	中学女生
子猫	小猫
漫研部員	漫研部员
進行	进行
川口先生	川口先生
運転手	司机
館長	馆长
店員	店员
女コーチ	女教练
陸上部員	田径部员
