治見	治见	name,teacher
二階堂	二阶堂	name,man,teacher
スダ	苏达	name,man
イズミ	泉	name,man
根津	根津	name,man,teacher
渡辺	渡边	name,man
チミチミ	奇米奇米	name,man,nick name of 治見,teacher
まぼちゃん	麻波酱	name
まぼ	麻波	name
真実	真实	first name of 桜井　真実,girl
桜井	樱井	lastname of 桜井　真実(girl)
明海	明海	first name of 皆月　明海,girl
皆月	皆月	lastname of 皆月　明海(girl)
小夜子	小夜子	first name of 芹沢　小夜子,girl
芹沢	芹沢	lastname of 芹沢　小夜子(girl)
菜摘	菜摘	first name of 藍田　菜摘,woman,teacher
藍田	蓝田	lastname of 藍田　菜摘(woman,teacher)
まゆ子	真由子	first name of 野島　まゆ子,girl
野島	野岛	lastname of 野島　まゆ子(girl)
玖美子	玖美子	first name of 羽根田　玖美子,girl
羽根田	羽根田	lastname of 羽根田　玖美子(girl)
望夫	望夫	first name of 丹羽　望夫,man
丹羽	丹羽	lastname of 丹羽　望夫(man)
百合恵	百合恵	first name of 東野　百合恵,woman,teacher
東野	东野	lastname of 東野　百合恵(woman,teacher)
昌俊	昌俊	first name of 片山　昌俊,man
片山	片山	lastname of 片山　昌俊(man)
義和	义和	first name of 田口　義和,man
田口	田口	lastname of 田口　義和(man)
育巳	育巳	first name of 福崎　育巳,man
福崎	福崎	lastname of 福崎　育巳(man)
良	良	first name of 矢崎　良,
矢崎	矢崎	lastname of 矢崎　良()
守男	守男	first name of 森　守男,man
森	森	lastname of 森　守男(man)
篤子	笃子	first name of 藤原　篤子,girl
藤原	藤原	lastname of 藤原　篤子(girl)
香津実	香津实	first name of 石川　香津実,girl
石川	石川	lastname of 石川　香津実(girl)
纯	纯	first name of 保科　纯,man
保科	保科	lastname of 保科　纯(man)
