ふゆり	冬璃	name, girl
あきそら	秋穹	name, girl
きいゆ	木柚	name, girl
ふうの	风乃	name, girl
とと	豆豆	name, girl
こはね	心羽	name, girl
ゆきな	雪奈	name, girl
みずみ	美澄	name, girl
うさぎ	兔	name, girl
つきよ	月夜	name, girl
ひなほ	雏穗	name, girl
さーしゃ	纱夏	name, girl
ほのわ	萌羽	name, girl
ふぃあ	菲亚	name, girl
しらすな	白纱奈	name, girl
ちぐさ	千草	name, girl
おおか	樱樱花	name, girl
みけ	美结	name, girl
たんぽぽ	蒲公英	name, girl
しい	椎	name, girl
ちこ	千子	name, girl
うう	兔兔	name, girl
使用人	佣人 or 女仆
委員長	委员长
しあ	夏亚	name, girl
あき	秋	name, girl,nickname of あきそら
しらす	白纱	name, girl,nickname of しらすな
こん	绀	name, girl
こんとん	混沌	name
こんちゃん	混沌酱	nickname of こんとん
しらぎり	白桐	name,girl,younger sisiter of ゆきな
ゆいひ	由希	name,girl,younger sisiter of ゆきな
シノ	志乃	name,girl
あすみ	明美	name,girl
なっちゃん	奈酱	name,girl
はーちゃん	薇酱	name,girl
しき	四季	name,girl
からあげ	炸鸡
あやみ	绫见	name,girl
みやこ	都	name,girl
みやちゃん	都酱	nickname of みやこ
ヒトガタ	人偶
いずみ	泉	name,girl
はづき	叶月	name,girl