葛の葉	葛之叶	name
ルーン	露恩	name
瀬高	濑高	name
安馬音	安马音	girl,安馬音音々's last name
音々	音音	girl,安馬音音々's first name
勇気	勇气	神楽勇気's first name,boy
神楽	神乐	神楽勇気's last name,boy
モイライ	木乃伊
影縫	影缝	name
しゃあ	煞	name
澄之院	澄之院	girl,澄之院桜花's last name
桜花	樱花	girl,澄之院桜花's first name
フィンブル	芬布尔	name
伏見	伏见	name
守護者	守护者
キリン	麒麟	name
朱雀	朱雀	name
鳳	凤	girl,神楽勇気's younger sister,鳳苍衣's last name
蒼衣	苍衣	girl,神楽勇気's younger sister,鳳苍衣's first name
所沢	所泽	name
二宮	二宫	name
タロス	塔罗斯	name
雲雀ヶ丘	云雀之丘	girl,雲雀ヶ丘愛祈's last name
愛祈	爱祈	girl,雲雀ヶ丘愛祈's first name
シャカラ	沙卡拉	name
ゼピュロス	泽费洛斯	name
オロチ	大蛇	name
トルトニス	托尔托尼斯	name
前園	前园	name
鈴葉	铃叶	name
逢魔崎	逢魔崎	woman,逢魔崎沙夜子's last name,teacher
沙夜子	沙夜子	woman,逢魔崎沙夜子's first name,teacher
ツバキ	山茶花	name
灰島	灰岛	name
鬼斬り丸	鬼斩丸	name
ボノム・デ・ネージュ	博诺姆·德·内朱	name
マスター	御主