ペイオース	佩欧斯	name,girl
ジークルーネ	吉可露妮	name,girl
ベルセルク	狂战士	name
ファフナー	法夫纳	name
ファゾルト	法索特	name
ニーズヘッグ	尼德霍格	name
フェンリル	芬里尔	name,girl
みおり	澪璃	name,girl
しほ	诗帆	name,girl
ハガル	夏甲	first name of ハガルヴァルキリー,girl
ソル	索尔	first name of ソルヴァルキリー,girl
ヴァルキリー	瓦尔基里	lastname of ハガルヴァルキリー(girl) and ソルヴァルキリー(girl)
詩帆	诗帆	first name of 来島詩帆,girl
来島	来岛	lastname of 来島詩帆(girl)
澪璃	澪璃	first name of 浅海澪璃,girl
浅海	浅海	lastname of 浅海澪璃(girl)
珠子	珠子	first name of 村上珠子,girl,elder sister of 琉平
琉平	琉平	first name of 村上琉平,boy
村上	村上	lastname of 村上珠子(girl,elder sister of 琉平) and 村上琉平(boy)
刹那	刹那	first name of 鳳条刹那,woman,teacher
鳳条	凤条	lastname of 鳳条刹那(woman,teacher)
深吾	深吾	first name of 海良宜深吾,man
海良宜	海良宜	lastname of 海良宜深吾(man)
蓮十朗	连十朗	first name of 九鬼蓮十朗,man
九鬼	九鬼	lastname of 九鬼蓮十朗(man)
兵衛	兵卫	first name of 北条兵衛,man
北条	北条	lastname of 北条兵衛(man)
郁人	郁人	first name of 鴻埜郁人,man,teacher
鴻埜	鸿埜	lastname of 鴻埜郁人(man,teacher)
ヴァルハラ	瓦尔哈拉	
マスター	主人	
