ヴァンチェスタ	范切斯特	name
プリム	普莉姆	first name of オクレイン＝リナ＝プリム,girl,Twin sister of ライム
リナ	莉娜	middle name of オクレイン＝リナ＝プリム,girl,Twin sister of ライム
ライム	莱姆	first name of オクレイン＝ルナ＝ライム,girl,Twin sister of プリム
ルナ	露娜	middle name of オクレイン＝ルナ＝ライム,girl,Twin sister of プリム
オクレイン	奥克雷恩	lastname of オクレイン＝リナ＝プリム(girl,Twin sister of ライム) and オクレイン＝ルナ＝ライム(girl,Twin sister of プリム)
マリアフィア	玛丽亚菲娅	first name of シフォネーゼ＝マリアフィア,girl
シフォネーゼ	西波内斯	lastname of シフォネーゼ＝マリアフィア(girl)
ミンティア	明蒂亚	first name of ミディム＝ミミット＝ミンティア,girl
ミミット	米米特	middle name of ミディム＝ミミット＝ミンティア,girl
ミディム	米迪姆	lastname of ミディム＝ミミット＝ミンティア(girl)
チャイム	查伊姆	first name of ミルフォークス＝チャイム,girl,younger sister of セラフィナ
セラフィナ	塞拉菲娜	first name of ミルフォークス＝セラフィナ,girl,elder sister of チャイム
ミルフォークス	米尔福克斯	lastname of ミルフォークス＝チャイム(girl,younger sister of セラフィナ) and ミルフォークス＝セラフィナ(girl,elder sister of チャイム)
日奈々	日奈奈	first name of 六桜日奈々,girl,younger sister of 琥珀
六桜	六樱	lastname of 六桜日奈々(girl,younger sister of 琥珀)
リカルド	里卡多	first name of ガディオン＝リカルド,man,teacher
ガディオン	加迪翁	lastname of ガディオン＝リカルド(man,teacher)
アルフレッド	阿尔弗雷德	first name of セバスチャン＝アルフレッド,man,Butler
セバスチャン	塞巴斯蒂安	lastname of セバスチャン＝アルフレッド(man,Butler)
六桜	六樱	first name of 琥珀六桜,boy,elder brother of 日奈々
琥珀	琥珀	lastname of 琥珀六桜(boy,elder brother of 日奈々)
エンリコ	恩里科	first name of フルラネット＝エンリコ,man,teacher
フルラネット	弗拉内托	lastname of フルラネット＝エンリコ(man,teacher)
ルルノア	露露诺亚	first name of トラエッタ＝ロロ＝ルルノア,woman,teacher
ロロ	洛洛	middle name of トラエッタ＝ロロ＝ルルノア,woman,teacher
トラエッタ	特拉埃塔	lastname of トラエッタ＝ロロ＝ルルノア(woman,teacher)
ジャコモ	贾科莫	first name of シジズモンド＝デリ＝ジャコモ,man
デリ	德里	middle name of シジズモンド＝デリ＝ジャコモ,man
シジズモンド	西斯蒙德	lastname of シジズモンド＝デリ＝ジャコモ(man)
アニタ	安妮塔	first name of ノーノ＝アニタ,girl
ノーノ	诺诺	lastname of ノーノ＝アニタ(girl)
タルンカッペ	塔伦卡佩	first name of ソロ＝タルンカッペ,teacher
ソロ	索罗	lastname of ソロ＝タルンカッペ(teacher)
シャロン	莎朗	first name of エルフィーナ＝シャロン,girl
エルフィーナ	埃尔菲娜	lastname of エルフィーナ＝シャロン(girl)
ユキ	雪	first name of クランド＝ユキ,girl
クランド	库尔兰	lastname of クランド＝ユキ(girl)
ネモ	尼莫	first name of ルイージャ＝ネモ,boy
ルイージャ	卢拉	lastname of ルイージャ＝ネモ(boy)
ロベルト	罗伯特	first name of エンツォ＝ロベルト,
エンツォ	恩佐	lastname of エンツォ＝ロベルト()
キリカ	基里卡	first name of フェネシュ＝キリカ,gilr,teacher
フェネシュ	费内斯	lastname of フェネシュ＝キリカ(gilr,teacher)
ファテシア	法特西亚	first name of ヴァンチェスタ＝セインテリア＝ファテシア,girl
セインテリア	塞恩特里亚	middle name of ヴァンチェスタ＝セインテリア＝ファテシア,girl
ヴァンチェスタ	范切斯塔	lastname of ヴァンチェスタ＝セインテリア＝ファテシア(girl)
ブラネリー	布拉内利	first name of カルシモンド＝トロア＝ブラネリー,man,teacher
トロア	特洛亚	middle name of カルシモンド＝トロア＝ブラネリー,man,teacher
カルシモンド	卡尔西蒙德	lastname of カルシモンド＝トロア＝ブラネリー(man,teacher)
エンジェス	Ａｎｇｅｓ
ソーサラー	Ｓｏｒｃｅｒｅｒ
フェアリーテイラー	Ｆａｉｒｙｔａｌｅｒ
シュヴァリエ	Ｃｈｅｖａｌｉｅｒ
セラフィム	Ｓｅｒａｐｈｉｍ
リッター	Ｒｉｔｔｅｒ
グロリア	格洛里亚
リュカオン	卢考恩
アルレシャ	阿勒西亚
カリーナ	卡琳娜
天鈴	天铃
ソルイルナ	索尔伊尔纳
ホーリーベル	圣钟	name of hotel
パルティータ	帕蒂塔