ロゼット	罗塞特	name,girl
バルザード	巴尔扎德	name,girl
テレシア	特蕾西娅	first name of テレシア・フォン・ローゼンバーグ,girl
フォン	冯	middle name of テレシア・フォン・ローゼンバーグ,girl
エレーゼ	艾莉婕	first name of エレーゼ・フォン・ローゼンバーグ,woman,mother of テレシア
フォン	冯	middle name of エレーゼ・フォン・ローゼンバーグ,woman,mother of テレシア
ローゼンバーグ	罗森堡	lastname of テレシア・フォン・ローゼンバーグ(girl) and エレーゼ・フォン・ローゼンバーグ(woman,mother of テレシア)
ランシング	兰辛格	first name of ランシング・アデナウアー,girl
アデナウアー	阿登纳	lastname of ランシング・アデナウアー(girl)
ハヤメ	哈雅梅	first name of ハヤメ・シュナイダー,girl
シュナイダー	施耐德	lastname of ハヤメ・シュナイダー(girl)
ヒスイ	凪原	first name of ヒスイ・ナギハラ,girl
ナギハラ	翡翠	lastname of ヒスイ・ナギハラ(girl)
エグゼリカ	艾格杰利卡	first name of エグゼリカ・コール,girl
コール	科尔	lastname of エグゼリカ・コール(girl)
ジェミニ	杰米妮	first name of ジェミニ・ヴァール,girl
ヴァール	瓦尔	lastname of ジェミニ・ヴァール(girl)
マリー	玛丽	first name of マリー・ハルドヴィック,girl
ハルドヴィック	海德温克	lastname of マリー・ハルドヴィック(girl)
スプライツ	施普莱滋	first name of スプライツ・マイヤー,girl,twin sister of ティンクル
ティンクル	汀可儿	first name of ティンクル・マイヤー,girl,twin sister of スプライツ
マイヤー	迈亚	lastname of スプライツ・マイヤー(girl,twin sister of ティンクル) and ティンクル・マイヤー(girl,twin sister of スプライツ)
シャーリーン	夏琳	first name of シャーリーン・アウスト,girl
アウスト	奥斯特	lastname of シャーリーン・アウスト(girl)
アンジェラ	安洁拉	first name of アンジェラ・エアハルト,girl
エアハルト	爱哈特	lastname of アンジェラ・エアハルト(girl)
ガナック	加纳克	first name of ガナック・ハインスト,girl
ハインスト	海恩斯特	lastname of ガナック・ハインスト(girl)
ミッドガルド	米德加德	name of place
アースガルド	阿斯加德	name of place
ビフレスト	比弗斯特	name of place
ゴーレム	傀儡
オーク	欧库
スライム	史莱姆	name
セシーラ	塞西拉	name
ゾディアック	佐迪亚克	name
マーズ	玛斯	name
ヴォルガード	沃尔加德	name
メイド	女仆
